##############################################################################################################################################################################################################################################
# #      #               #     #    #      #               #     #    #      #               #     #    #      #               #     #    #      #               #     #    #      #               #     #    #      #               #     #S#
# # ## #    ###########  # ### # ## # ## #    ###########  # ### # ## # ## #    ###########  # ### # ## # ## #    ###########  # ### # ## # ## #    ###########  # ### # ## # ## #    ###########  # ### # ## # ## #    ###########  # ### # #
#      # #  #    #    #  #   # # ##      # #  #    #    #  #   # # ##      # #  #    #    #  #   # # ##      # #  #    #    #  #   # # ##      # #  #    #    #  #   # # ##      # #  #    #    #  #   # # ##      # #  #    #    #  #   # # #
##########  # ####### #  # # # # ###########  # ####### #  # # # # ###########  # ####### #  # # # # ###########  # ####### #  # # # # ###########  # ####### #  # # # # ###########  # ####### #  # # # # ###########  # ####### #  # # # # #
#        #  # #     # #  # # # # ##        #  # #     # #  # # # # ##        #  # #     # #  # # # # ##        #  # #     # #  # # # # ##        #  # #     # #  # # # # ##        #  # #     # #  # # # # ##        #  # #     # #  # # # # #
# ######    # # # # # #  # # # # ## ######    # # # # # #  # # # # ## ######    # # # # # #  # # # # ## ######    # # # # # #  # # # # ## ######    # # # # # #  # # # # ## ######    # # # # # #  # # # # ## ######    # # # # # #  # # # # #
#        #  # # # # # # ###### # ##        #  # # # # # # ###### # ##        #  # # # # # # ###### # ##        #  # # # # # # ###### # ##        #  # # # # # # ###### # ##        #  # # # # # # ###### # ##        #  # # # # # # ###### # #
##########  #   # #   #        # ###########  #   # #   #        # ###########  #   # #   #        # ###########  #   # #   #        # ###########  #   # #   #        # ###########  #   # #   #        # ###########  #   # #   #        # #
#        #  ##### ############ # ##        #  ##### ############ # ##        #  ##### ############ # ##        #  ##### ############ # ##        #  ##### ############ # ##        #  ##### ############ # ##        #  ##### ############ # #
#        #      # #   #      # # ##        #      # #   #      # # ##        #      # #   #      # # ##        #      # #   #      # # ##        #      # #   #      # # ##        #      # #   #      # # ##        #      # #   #      # # #
#  #  #  ###### # # ##### #### # ##  #  #  ###### # # ##### #### # ##  #  #  ###### # # ##### #### # ##  #  #  ###### # # ##### #### # ##  #  #  ###### # # ##### #### # ##  #  #  ###### # # ##### #### # ##  #  #  ###### # # ##### #### # #
#  #  #         # #     #      # ##  #  #         # #     #      # ##  #  #         # #     #      # ##  #  #         # #     #      # ##  #  #         # #     #      # ##  #  #         # #     #      # ##  #  #         # #     #      # #
#  #  #  ## ##### ##### ###### # ##  #  #  ## ##### ##### ###### # ##  #  #  ## ##### ##### ###### # ##  #  #  ## ##### ##### ###### # ##  #  #  ## ##### ##### ###### # ##  #  #  ## ##### ##### ###### # ##  #  #  ## ##### ##### ###### # #
####  ####  #   # #   # # # #  # #####  ####  #   # #   # # # #  # #####  ####  #   # #   # # # #  # #####  ####  #   # #   # # # #  # #####  ####  #   # #   # # # #  # #####  ####  #   # #   # # # #  # #####  ####  #   # #   # # # #  # #
#        ## # ### ### #        # ##        ## # ### ### #        # ##        ## # ### ### #        # ##        ## # ### ### #        # ##        ## # ### ### #        # ##        ## # ### ### #        # ##        ## # ### ### #        # #
# #    # #  # #     # ##### #### ## #    # #  # #     # ##### #### ## #    # #  # #     # ##### #### ## #    # #  # #     # ##### #### ## #    # #  # #     # ##### #### ## #    # #  # #     # ##### #### ## #    # #  # #     # ##### #### #
# #    # ## # #     #     # ## # ## #    # ## # #     #     # ## # ## #    # ## # #     #     # ## # ## #    # ## # #     #     # ## # ## #    # ## # #     #     # ## # ## #    # ## # #     #     # ## # ## #    # ## # #     #     # ## # #
# #    # #  # #  #  # # # # ## # ## #    # #  # #  #  # # # # ## # ## #    # #  # #  #  # # # # ## # ## #    # #  # #  #  # # # # ## # ## #    # #  # #  #  # # # # ## # ## #    # #  # #  #  # # # # ## # ## #    # #  # #  #  # # # # ## # #
# ##  ##### #         # # # #  # ## ##  ##### #         # # # #  # ## ##  ##### #         # # # #  # ## ##  ##### #         # # # #  # ## ##  ##### #         # # # #  # ## ##  ##### #         # # # #  # ## ##  ##### #         # # # #  # #
#  #  #     ##### ##### ### # ## ##  #  #     ##### ##### ### # ## ##  #  #     ##### ##### ### # ## ##  #  #     ##### ##### ### # ## ##  #  #     ##### ##### ### # ## ##  #  #     ##### ##### ### # ## ##  #  #     ##### ##### ### # ## #
## #### #####   #   #       #  # ### #### #####   #   #       #  # ### #### #####   #   #       #  # ### #### #####   #   #       #  # ### #### #####   #   #       #  # ### #### #####   #   #       #  # ### #### #####   #   #       #  # #
#     #     # # ### #       #  # ##     #     # # ### #       #  # ##     #     # # ### #       #  # ##     #     # # ### #       #  # ##     #     # # ### #       #  # ##     #     # # ### #       #  # ##     #     # # ### #       #  # #
##### ##### # #   ############## ###### ##### # #   ############## ###### ##### # #   ############## ###### ##### # #   ############## ###### ##### # #   ############## ###### ##### # #   ############## ###### ##### # #   ############## #
#   # #   # # ###              # ##   # #   # # ###              # ##   # #   # # ###              # ##   # #   # # ###              # ##   # #   # # ###              # ##   # #   # # ###              # ##   # #   # # ###              # #
### # # # # # #   #            # #### # # # # # #   #            # #### # # # # # #   #            # #### # # # # # #   #            # #### # # # # # #   #            # #### # # # # # #   #            # #### # # # # # #   #            # #
#   # # ##### # # # ##  #####  # ##   # # ##### # # # ##  #####  # ##   # # ##### # # # ##  #####  # ##   # # ##### # # # ##  #####  # ##   # # ##### # # # ##  #####  # ##   # # ##### # # # ##  #####  # ##   # # ##### # # # ##  #####  # #
# ### #     # #   # #       # ## ## ### #     # #   # #       # ## ## ### #     # #   # #       # ## ## ### #     # #   # #       # ## ## ### #     # #   # #       # ## ## ### #     # #   # #       # ## ## ### #     # #   # #       # ## #
#     # ##### # # # #       #  # ##     # ##### # # # #       #  # ##     # ##### # # # #       #  # ##     # ##### # # # #       #  # ##     # ##### # # # #       #  # ##     # ##### # # # #       #  # ##     # ##### # # # #       #  # #
# ##### #   ###   # ####### ## # ## ##### #   ###   # ####### ## # ## ##### #   ###   # ####### ## # ## ##### #   ###   # ####### ## # ## ##### #   ###   # ####### ## # ## ##### #   ###   # ####### ## # ## ##### #   ###   # ####### ## # #
#         #     # #    #     #   ##         #     # #    #     #   ##         #     # #    #     #   ##         #     # #    #     #   ##         #     # #    #     #   ##         #     # #    #     #   ##         #     # #    #     #   #
# ############################################################################################################################################################################################################################################
# ############################################################################################################################################################################################################################################
# #      #               #     #    #      #               #     #    #      #               #     #    #      #               #     #    #      #               #     #    #      #               #     #    #      #               #     # #
# # ## #    ###########  # ### # ## # ## #    ###########  # ### # ## # ## #    ###########  # ### # ## # ## #    ###########  # ### # ## # ## #    ###########  # ### # ## # ## #    ###########  # ### # ## # ## #    ###########  # ### # #
#      # #  #    #    #  #   # # ##      # #  #    #    #  #   # # ##      # #  #    #    #  #   # # ##      # #  #    #    #  #   # # ##      # #  #    #    #  #   # # ##      # #  #    #    #  #   # # ##      # #  #    #    #  #   # # #
##########  # ####### #  # # # # ###########  # ####### #  # # # # ###########  # ####### #  # # # # ###########  # ####### #  # # # # ###########  # ####### #  # # # # ###########  # ####### #  # # # # ###########  # ####### #  # # # # #
#        #  # #     # #  # # # # ##        #  # #     # #  # # # # ##        #  # #     # #  # # # # ##        #  # #     # #  # # # # ##        #  # #     # #  # # # # ##        #  # #     # #  # # # # ##        #  # #     # #  # # # # #
# ######    # # # # # #  # # # # ## ######    # # # # # #  # # # # ## ######    # # # # # #  # # # # ## ######    # # # # # #  # # # # ## ######    # # # # # #  # # # # ## ######    # # # # # #  # # # # ## ######    # # # # # #  # # # # #
#        #  # # # # # # ###### # ##        #  # # # # # # ###### # ##        #  # # # # # # ###### # ##        #  # # # # # # ###### # ##        #  # # # # # # ###### # ##        #  # # # # # # ###### # ##        #  # # # # # # ###### # #
##########  #   # #   #        # ###########  #   # #   #        # ###########  #   # #   #        # ###########  #   # #   #        # ###########  #   # #   #        # ###########  #   # #   #        # ###########  #   # #   #        # #
#        #  ##### ############ # ##        #  ##### ############ # ##        #  ##### ############ # ##        #  ##### ############ # ##        #  ##### ############ # ##        #  ##### ############ # ##        #  ##### ############ # #
#        #      # #   #      # # ##        #      # #   #      # # ##        #      # #   #      # # ##        #      # #   #      # # ##        #      # #   #      # # ##        #      # #   #      # # ##        #      # #   #      # # #
#  #  #  ###### # # ##### #### # ##  #  #  ###### # # ##### #### # ##  #  #  ###### # # ##### #### # ##  #  #  ###### # # ##### #### # ##  #  #  ###### # # ##### #### # ##  #  #  ###### # # ##### #### # ##  #  #  ###### # # ##### #### # #
#  #  #         # #     #      # ##  #  #         # #     #      # ##  #  #         # #     #      # ##  #  #         # #     #      # ##  #  #         # #     #      # ##  #  #         # #     #      # ##  #  #         # #     #      # #
#  #  #  ## ##### ##### ###### # ##  #  #  ## ##### ##### ###### # ##  #  #  ## ##### ##### ###### # ##  #  #  ## ##### ##### ###### # ##  #  #  ## ##### ##### ###### # ##  #  #  ## ##### ##### ###### # ##  #  #  ## ##### ##### ###### # #
####  ####  #   # #   # # # #  # #####  ####  #   # #   # # # #  # #####  ####  #   # #   # # # #  # #####  ####  #   # #   # # # #  # #####  ####  #   # #   # # # #  # #####  ####  #   # #   # # # #  # #####  ####  #   # #   # # # #  # #
#        ## # ### ### #        # ##        ## # ### ### #        # ##        ## # ### ### #        # ##        ## # ### ### #        # ##        ## # ### ### #        # ##        ## # ### ### #        # ##        ## # ### ### #        # #
# #    # #  # #     # ##### #### ## #    # #  # #     # ##### #### ## #    # #  # #     # ##### #### ## #    # #  # #     # ##### #### ## #    # #  # #     # ##### #### ## #    # #  # #     # ##### #### ## #    # #  # #     # ##### #### #
# #    # ## # #     #     # ## # ## #    # ## # #     #     # ## # ## #    # ## # #     #     # ## # ## #    # ## # #     #     # ## # ## #    # ## # #     #     # ## # ## #    # ## # #     #     # ## # ## #    # ## # #     #     # ## # #
# #    # #  # #  #  # # # # ## # ## #    # #  # #  #  # # # # ## # ## #    # #  # #  #  # # # # ## # ## #    # #  # #  #  # # # # ## # ## #    # #  # #  #  # # # # ## # ## #    # #  # #  #  # # # # ## # ## #    # #  # #  #  # # # # ## # #
# ##  ##### #         # # # #  # ## ##  ##### #         # # # #  # ## ##  ##### #         # # # #  # ## ##  ##### #         # # # #  # ## ##  ##### #         # # # #  # ## ##  ##### #         # # # #  # ## ##  ##### #         # # # #  # #
#  #  #     ##### ##### ### # ## ##  #  #     ##### ##### ### # ## ##  #  #     ##### ##### ### # ## ##  #  #     ##### ##### ### # ## ##  #  #     ##### ##### ### # ## ##  #  #     ##### ##### ### # ## ##  #  #     ##### ##### ### # ## #
## #### #####   #   #       #  # ### #### #####   #   #       #  # ### #### #####   #   #       #  # ### #### #####   #   #       #  # ### #### #####   #   #       #  # ### #### #####   #   #       #  # ### #### #####   #   #       #  # #
#     #     # # ### #       #  # ##     #     # # ### #       #  # ##     #     # # ### #       #  # ##     #     # # ### #       #  # ##     #     # # ### #       #  # ##     #     # # ### #       #  # ##     #     # # ### #       #  # #
##### ##### # #   ############## ###### ##### # #   ############## ###### ##### # #   ############## ###### ##### # #   ############## ###### ##### # #   ############## ###### ##### # #   ############## ###### ##### # #   ############## #
#   # #   # # ###              # ##   # #   # # ###              # ##   # #   # # ###              # ##   # #   # # ###              # ##   # #   # # ###              # ##   # #   # # ###              # ##   # #   # # ###              # #
### # # # # # #   #            # #### # # # # # #   #            # #### # # # # # #   #            # #### # # # # # #   #            # #### # # # # # #   #            # #### # # # # # #   #            # #### # # # # # #   #            # #
#   # # ##### # # # ##  #####  # ##   # # ##### # # # ##  #####  # ##   # # ##### # # # ##  #####  # ##   # # ##### # # # ##  #####  # ##   # # ##### # # # ##  #####  # ##   # # ##### # # # ##  #####  # ##   # # ##### # # # ##  #####  # #
# ### #     # #   # #       # ## ## ### #     # #   # #       # ## ## ### #     # #   # #       # ## ## ### #     # #   # #       # ## ## ### #     # #   # #       # ## ## ### #     # #   # #       # ## ## ### #     # #   # #       # ## #
#     # ##### # # # #       #  # ##     # ##### # # # #       #  # ##     # ##### # # # #       #  # ##     # ##### # # # #       #  # ##     # ##### # # # #       #  # ##     # ##### # # # #       #  # ##     # ##### # # # #       #  # #
# ##### #   ###   # ####### ## # ## ##### #   ###   # ####### ## # ## ##### #   ###   # ####### ## # ## ##### #   ###   # ####### ## # ## ##### #   ###   # ####### ## # ## ##### #   ###   # ####### ## # ## ##### #   ###   # ####### ## # #
#         #     # #    #     #   ##         #     # #    #     #   ##         #     # #    #     #   ##         #     # #    #     #   ##         #     # #    #     #   ##         #     # #    #     #   ##         #     # #    #     # X #
##############################################################################################################################################################################################################################################


