#######################
#S                    #
#                     #
#                     #
#                     #
#                     #
#                     #
#                     #
#       #            X#
#######################

