#######################
#S                    #
#                     #
#                     #
#                     #
#          X          #
#                     #
#                     #
#       #             #
#######################

